GUI_GENERATED_MAP
NewMap
PLAYERS 1

MAP
30 X 30
OaOaOaOaOaOaOaOaOaOaOaOaOaOaOaOaOaOaOaOaOaOaOaOaOaOaOaOaOaOa
OaObObObObObObObObObObObObObObObObObObObObObObObObObObObObOa
OaObOcOcOcOcOcOcOcOcOcOcOcOcOcOcOcOcOcOcOcOcOcOcOcOcOcOcObOa
OaObOcOgOgOgOcOcOcOcOcOcOcOcOcOcOcOcOcOcOcOcOcOcOcOcOcOcObOa
OaObOcOgOgOgOgOcOcOcOcOcOcOcOcOcOcOcOcOcOcOcOcOcOcOcOcOcObOa
OaObOcOgOgOgOcOcOcOcOcOcOcOcOcOcOcOcOcOcOcOcOcOcOcOcOcOcObOa
OaObOcOgOgOgOcOcOcOcOcOcOcOgOcOcOcOcOcOcOcOcOcOcOcOcOcOcObOa
OaObOcOcOgOcOcOcOcOcOcOcOcOgOgOgOgOgOcOcOcOcOcOcOcOcOcOcObOa
OaObOcOcOcOcOcOcOcOcOcOcOcOgOgOgOgOgOcOcOcOcOcOcOcOcOcOcObOa
OaObOcOcOcOcOcOcOcOcOcOcOcOcOgOgOgOgOcOcOcOcOcOcOcOcOcOcObOa
OaObOcOcOcOcOcOcOcOcOcOcOcOcOgOgOgOgOcOcOcOcOcOcOcOcOcOcObOa
OaObOcOcOcOcOcOeOeOeOcOcOcOcOcOgOgOcOcOcOcOcOcOcOcOcOcOcObOa
OaObOcOcOcOcOcOeOeOeOeOeOeOe1A1A1AOcOcOcOcOcOcOcOcOcOcOcObOa
OaObOcOcOcOcOcOeOeOeOeOeOeOeOeOdOeOeOeOeOeOcOcOcOcOcOcOcObOa
OaObOcOcOcOcOcOcOeOeOeOeOeOeOe1AOeOeOeOeOeOcOcOcOcOcOcOcObOa
OaObOcOcOcOcOcOcOcOeOeOe1C1C1C1C1C1C1COeOeOcOcOcOcOcOcOcObOa
OaObOcOcOdOdOdOcOcOeOeOe1C1G1G1G1G1G1COeOeOcOcOcOcOcOcOcObOa
OaObOcOcOdOcOdOcOcOcOeOe1C1G1G1G1G1G1COeOeOcOcOcOc1E1E1EObOa
OaObOcOcOdOcOdOdOdOdOd1A1C1G1G1G1G1G1C1A1AOdOdOdOd1E1E1EObOa
OaObOcOdOdOcOcOcOcOcOeOe1C1G1G1G1G1G1COeOeOeOcOcOc1E1E1EObOa
OaObOcOdOdOdOcOcOeOeOeOe1C1G1G1G1G1G1COeOeOeOcOcOcOcOcOcObOa
OaObOcOdOdOdOcOeOeOeOeOe1C1C1C1C1C1C1COeOeOeOcOcOcOcOcOcObOa
OaObOcOdOdOdOcOeOeOeOeOeOeOeOe1AOeOeOeOeOeOeOcOcOcOcOcOcObOa
OaObOcOgOgOcOcOcOeOeOeOeOeOeOeOdOeOeOeOeOeOeOcOcOcOcOcOcObOa
OaObOcOcOgOcOcOcOcOeOeOcOcOcOcOgOcOcOcOcOcOcOcOcOcOcOcOcObOa
OaObOcOcOgOgOcOcOcOcOcOcOcOgOgOgOgOgOcOcOcOcOcOcOcOcOcOcObOa
OaObOcOcOgOgOcOcOcOcOcOcOgOgOgOgOgOgOgOcOcOcOcOcOcOcOcOcObOa
OaObOcOcOcOcOcOcOcOcOcOcOcOcOcOcOcOcOcOcOcOcOcOcOcOcOcOcObOa
OaObObObObObObObObObObObObObObObObObObObObObObObObObObObObOa
OaOaOaOaOaOaOaOaOaOaOaOaOaOaOaOaOaOaOaOaOaOaOaOaOaOaOaOaOaOa

THINGS
0

CREATURES
2
IMP 15 16 L1 P1
IMP 15 13 L1 P1

DOORS
0

TRAPS
0

HEARTS_AND_GOLD
KPR1_HEART_CENTER 15 18
GOLD1 0

HERO_BANDS
0

AREAS
0

HERO_GATES
0

TRIGGERS
0

SCENARIO_DESCRIPTION
EOF
