GUI_GENERATED_MAP
NewMap
PLAYERS 1

MAP
40 X 40
OaOaOaOaOaOaOaOaOaOaOaOaOaOaOaOaOaOaOaOaOaOaOaOaOaOaOaOaOaOaOaOaOaOaOaOaOaOaOaOa
OaObObObObObObObObObObObObObObObObObObObObObObObObObObObObObObObObObObObObObObOa
OaObOcOcOcOcOcOcOcOcOcOcOcOcOcOcOcOcOcOcOcOcOcOcOcOcOcOcOcOcOcOcOcOcOcOcOcOcObOa
OaObOcOcOcOcOcOcOcOcOcOcOcOcOcOcOcOcOcOcOcOcOcOcOcOcOcOcOcOcOcOcOcOcOcOcOcOcObOa
OaObOcOcOcOcOcOcOcOcOcOcOcOcOcOcOcOcOcOcOcOcOcOcOcOcOcOcOcOcOcOcOcOcOcOcOcOcObOa
OaObOcOcOcOcOcOcOcOcOcOcOcOcOcOcOcOcOcOcOcOcOcOcOcOcOcOcOcOcOcOcOcOcOcOcOcOcObOa
OaObOcOcOcOcOcOcOcOcOcOcOcOcOcOcOcOcOcOcOcOcOcOcOcOcOcOdOdOdOcOcOcOcOcOcOcOcObOa
OaObOcOcOcOcOcOcOcOeOeOcOeOeOcOcOcOcOcOcOcOcOcOcOcOcOcOdOdOdOcOcOcOcOcOcOcOcObOa
OaObOcOcOcOcOcOcOeOeOeOeOeOeOcOcOcOcOcOcOcOcOcOcOcOcOcOdOdOdOcOcOcOcOcOcOcOcObOa
OaObOcOcOcOcOcOcOeOeOeOeOeOeOcOcOcOcOcOcOcOcOcOcOcOcOcOdOcOcOcOcOcOcOcOcOcOcObOa
OaObOcOcOcOcOcOcOeOeOeOeOeOeOeOcOcOcOcOcOcOcOcOcOcOcOcOdOcOcOcOcOcOcOcOcOcOcObOa
OaObOcOcOcOcOcOcOeOeOeOeOeOeOeOcOcOcOcOcOgOgOcOcOcOcOcOdOcOcOcOcOcOcOcOcOcOcObOa
OaObOcOcOcOcOcOeOeOeOeOeOeOeOeOeOcOcOcOcOcOgOgOgOcOcOdOdOcOcOcOcOcOcOcOcOcOcObOa
OaObOcOcOcOcOcOeOeOeOeOeOeOeOeOeOeOcOcOcOcOcOgOgOcOcOdOdOdOdOcOcOcOcOcOcOcOcObOa
OaObOcOcOcOcOcOcOeOeOeOeOeOeOeOeOeOcOcOdOdOdOdOcOcOc1F1F1FOdOcOcOcOcOcOcOcOcObOa
OaObOcOcOcOcOcOcOcOeOeOeOeOeOeOeOeOeOcOdOd1F1F1FOdOc1F1F1FOdOcOcOcOcOcOcOcOcObOa
OaObOcOcOcOcOcOcOcOcOeOeOeOeOeOeOeOeOcOcOd1F1F1FOdOd1F1F1FOdOcOcOcOcOcOcOcOcObOa
OaObOcOcOcOcOcOcOcOc1B1B1B1B1BOeOeOeOeOcOd1F1F1FOdOdOcOcOcOdOcOcOcOcOcOcOcOcObOa
OaObOcOcOc1B1B1B1B1B1BOcOcOc1BOeOeOeOeOcOdOcOcOcOcOdOdOdOdOdOcOcOcOcOcOcOcOcObOa
OaObOcOcOc1B1I1I1I1A1AOcOcOc1BOeOeOeOeOe1AOeOeOeOcOcOcOcOcOdOcOcOcOcOcOcOcOcObOa
OaOb1B1B1B1B1I1I1I1B1BOcOcOc1BOeOeOeOeOe1AOeOeOeOeOcOcOcOcOdOcOcOcOcOcOcOcOcObOa
OaOb1B1F1F1F1I1I1I1B1B1B1B1B1BOeOeOeOe1B1A1BOeOeOeOeOeOeOcOdOcOcOcOcOcOcOcOcObOa
OaOb1B1F1F1F1F1F1F1BOcOcOeOeOeOeOeOe1C1C1A1C1COeOeOeOeOeOcOdOcOcOcOcOcOcOcOcObOa
OaOb1B1F1F1F1F1F1F1B1B1B1B1BOeOeOe1C1G1G1G1G1G1COeOeOeOeOcOdOcOcOcOcOcOcOcOcObOa
OaOb1B1F1F1F1F1F1F1B1D1D1D1BOeOeOe1C1G1G1G1G1G1C1BOeOeOcOcOdOc1E1E1EOcOcOcOcObOa
OaOb1B1F1F1F1F1F1F1A1D1D1D1A1A1A1A1A1G1G1G1G1G1A1A1A1AOdOdOdOc1E1E1EOcOcOcOcObOa
OaOb1B1F1F1F1F1F1F1B1D1D1D1BOcOeOeOe1G1G1G1G1G1C1BOeOeOcOcOcOc1E1E1EOcOcOcOcObOa
OaOb1B1B1B1B1F1F1F1A1D1D1D1BOcOeOeOe1G1G1G1G1G1COeOeOeOcOcOcOcOcOcOcOcOcOcOcObOa
OaObOcOcOc1B1F1F1F1A1D1D1D1B1B1B1BOe1C1C1A1C1COeOeOeOcOcOcOcOcOcOcOcOcOcOcOcObOa
OaObOcOcOc1B1B1B1A1A1D1D1D1D1D1D1BOeOe1B1A1BOeOeOeOeOcOcOcOcOcOcOcOcOcOcOcOcObOa
OaObOcOcOcOc1B1D1D1D1D1D1D1D1D1D1BOeOeOe1AOeOeOeOeOeOeOcOcOcOcOcOcOcOcOcOcOcObOa
OaObOcOcOcOc1B1D1D1D1D1D1D1D1D1D1BOeOeOeOgOcOcOeOeOeOeOcOcOcOcOcOcOcOcOcOcOcObOa
OaObOcOcOcOc1B1D1D1D1D1D1D1B1B1B1BOcOcOgOgOgOcOcOcOeOeOcOcOcOcOcOcOcOcOcOcOcObOa
OaObOcOcOcOc1B1B1B1B1B1B1B1BOcOcOcOcOcOgOgOgOcOcOcOcOcOcOcOcOcOcOcOcOcOcOcOcObOa
OaObOcOcOcOcOcOcOcOcOcOcOcOcOcOcOcOcOgOgOgOgOgOcOcOcOcOcOcOcOcOcOcOcOcOcOcOcObOa
OaObOcOcOcOcOcOcOcOcOcOcOcOcOcOcOcOcOgOgOgOgOcOcOcOcOcOcOcOcOcOcOcOcOcOcOcOcObOa
OaObOcOcOcOcOcOcOcOcOcOcOcOcOcOcOcOcOcOcOcOcOcOcOcOcOcOcOcOcOcOcOcOcOcOcOcOcObOa
OaObOcOcOcOcOcOcOcOcOcOcOcOcOcOcOcOcOcOcOcOcOcOcOcOcOcOcOcOcOcOcOcOcOcOcOcOcObOa
OaObObObObObObObObObObObObObObObObObObObObObObObObObObObObObObObObObObObObObObOa
OaOaOaOaOaOaOaOaOaOaOaOaOaOaOaOaOaOaOaOaOaOaOaOaOaOaOaOaOaOaOaOaOaOaOaOaOaOaOaOa

THINGS
0

CREATURES
28
GOBLIN 26 25 L1 P1
THIEF 26 25 L1 P1
TROLL 15 25 L1 P1
TROLL 23 25 L1 P1
TROLL 20 21 L1 P1
THIEF 6 22 L1 P1
THIEF 8 24 L1 P1
IMP 7 25 L1 P1
IMP 20 20 L1 P1
WARLOCK 20 29 L1 P1
GOBLIN 26 12 L1 P1
WARLOCK 27 12 L1 P1
GOBLIN 24 16 L1 P1
GOBLIN 27 6 L1 P1
GOBLIN 29 6 L1 P1
GOBLIN 27 9 L1 P1
GOBLIN 29 13 L1 P1
GOBLIN 19 14 L1 P1
GOBLIN 19 14 L1 P1
GOBLIN 19 14 L1 P1
GOBLIN 19 14 L1 P1
GOBLIN 19 14 L1 P1
TROLL 22 14 L1 P1
TROLL 22 14 L1 P1
TROLL 22 16 L1 P1
TROLL 22 16 L1 P1
TROLL 29 8 L1 P1
TROLL 29 8 L1 P1

DOORS
0

TRAPS
0

HEARTS_AND_GOLD
KPR1_HEART_CENTER 20 25
GOLD1 0

HERO_BANDS
0

AREAS
0

HERO_GATES
0

TRIGGERS
0

SCENARIO_DESCRIPTION
EOF
