GUI_GENERATED_MAP
NewMap
PLAYERS 1

MAP
30 X 30
OaOaOaOaOaOaOaOaOaOaOaOaOaOaOaOaOaOaOaOaOaOaOaOaOaOaOaOaOaOa
OaObObObObObObObObObObObObObObObObObObObObObObObObObObObObOa
OaObOcOcOcOcOcOcOcOcOcOcOcOcOcOcOcOcOcOcOcOcOcOcOcOcOcOcObOa
OaObOcOgOgOgOcOcOcOcOcOcOcOcOcOcOcOcOcOcOcOcOcOcOcOcOcOcObOa
OaObOcOgOgOgOgOcOcOcOcOcOcOcOcOcOcOcOcOcOcOcOcOcOcOcOcOcObOa
OaObOcOgOgOgOcOcOcOcOcOcOcOcOcOcOcOcOcOcOcOcOcOcOcOcOcOcObOa
OaObOcOgOgOgOcOcOcOcOcOcOcOgOcOcOcOcOcOcOcOcOcOcOcOcOcOcObOa
OaObOcOcOgOcOcOcOcOcOcOcOcOgOgOgOgOgOcOcOcOcOcOcOcOcOcOcObOa
OaObOcOcOcOcOcOcOcOcOcOcOcOgOgOgOgOgOcOcOcOcOcOcOcOcOcOcObOa
OaObOcOcOcOcOcOcOcOcOcOcOcOcOgOgOgOgOcOcOcOcOcOcOcOcOcOcObOa
OaObOcOcOcOcOcOcOcOcOcOcOcOcOgOgOgOgOcOcOcOcOcOcOcOcOcOcObOa
OaObOcOcOcOcOcOeOeOeOcOcOcOcOcOgOgOcOcOcOcOcOcOcOcOcOcOcObOa
OaObOc1D1D1DOcOeOeOeOeOeOeOe1A1A1AOcOcOcOcOcOcOcOcOcOcOcObOa
OaObOc1D1D1DOcOeOeOeOeOeOeOeOe1AOeOeOeOeOeOcOcOcOcOcOcOcObOa
OaObOc1D1D1DOcOcOeOeOeOeOeOeOe1AOeOeOeOeOeOcOcOcOcOcOcOcObOa
OaObOc1D1D1DOcOcOcOeOeOe1C1C1C1C1C1C1COeOeOcOcOcOcOcOcOcObOa
OaObOcOcOcOdOcOcOcOeOeOe1C1G1G1G1G1G1COeOeOcOcOcOcOcOcOcObOa
OaObOcOc1I1I1IOcOcOcOeOe1C1G1G1G1G1G1COeOeOcOcOcOcOdOdOdObOa
OaObOcOc1I1I1IOdOdOdOd1A1C1G1G1G1G1G1C1A1AOdOdOdOdOdOdOdObOa
OaObOcOc1I1I1IOcOcOcOeOe1C1G1G1G1G1G1COeOeOeOcOcOcOdOdOdObOa
OaObOcOcOcOdOcOcOeOeOeOe1C1G1G1G1G1G1COeOeOeOcOcOcOcOcOcObOa
OaObOcOcOcOdOcOeOeOeOeOe1C1C1C1C1C1C1COeOeOeOcOcOcOcOcOcObOa
OaObOcOc1F1F1FOeOeOeOeOeOeOeOe1AOeOeOeOeOeOeOcOcOcOcOcOcObOa
OaObOcOc1F1F1FOcOeOeOeOeOeOeOeOdOeOeOeOeOeOeOcOcOcOcOcOcObOa
OaObOcOc1F1F1FOcOcOeOeOcOcOcOcOgOcOcOcOcOcOcOcOcOcOcOcOcObOa
OaObOcOc1F1F1FOcOcOcOcOcOcOgOgOgOgOgOcOcOcOcOcOcOcOcOcOcObOa
OaObOcOc1F1F1FOcOcOcOcOcOgOgOgOgOgOgOgOcOcOcOcOcOcOcOcOcObOa
OaObOcOc1F1F1FOcOcOcOcOcOcOcOcOcOcOcOcOcOcOcOcOcOcOcOcOcObOa
OaObObObObObObObObObObObObObObObObObObObObObObObObObObObObOa
OaOaOaOaOaOaOaOaOaOaOaOaOaOaOaOaOaOaOaOaOaOaOaOaOaOaOaOaOaOa

THINGS
0

CREATURES
2
IMP 13 18 L1 PN
GOBLIN 9 18 L1 PN

DOORS
0

TRAPS
0

HEARTS_AND_GOLD
KPR1_HEART_CENTER 15 18
GOLD1 0

HERO_BANDS
0

AREAS
0

HERO_GATES
0

TRIGGERS
0

SCENARIO_DESCRIPTION
EOF
